10 10
..........
..........
..........
..........
..........
====HH====
....HH....
====HH====
....HH....
xxxxxxxxxx
