15 10
...............
...............
...............
...............
...............
...............
.==H...........
...H...........
===============
XXXXXXXXXXXXXXX
2 2
0,2;1,2
14,2